ABACATE=uma fruta
ABACATEIRO=árvore frutífera|uma árvore|uma planta
ABACAXI=uma fruta|fruta cítrica
ÁBACO=utilizado em cálculos|cálculos matemáticos
ABAJUR=objeto de decoração|protege os olhos da luz forte
ABDÔMEN=parte do corpo humano
ABELHA=um inseto|inseto alado
ABÓBORA=fruta utilizada em culinária|utilizado em culinária|uma fruta
ABORÍGINE=natural de um país|habitante primitivo
ABUTRE=ave de rapina|uma ave
ACÁCIA=árvore ornamental|uma planta|uma árvore
AÇAFRÃO=uma planta|tempero utilizado na culinária
AÇAÍ=uma fruta
AÇAIZEIRO=uma árvore|uma palmeira|uma planta
ACARAJÉ=iguaria feita com feijão|relativo a culinária
ACELGA=uma planta
ACNE=doença de pele|uma doença
ACORDEÃO=instrumento musical
ACROFOBIA=relativo a altura
AÇUCENA=planta ornamental|uma planta
ADEGA=relativo a vinho
ADESIVO=cola|material colante
ADRENALINA=um hormônio
ADVOGADO=protetor|defensor
AERODINÂMICO=relativo a forma
AERONÁUTICA=relativo a aviação
AERONAVE=relativo a aviação
AERONAVEGAÇÃO=relativo a aviação
ÁGATA=pedra semipreciosa|um mineral|uma pedra
AGENDA=pequeno livro|anotação de compromissos|anotação de encontros
BABAÇU=uma espécie palmeira|uma árvore|uma planta
BABOSA=uma planta
BACALHAU=um peixe
BACTÉRIA=ser unicelular|um microorganismo
BAFÔMETRO=um aparelho
BAGRE=um peixe
BAIACU=um peixe
BAIXO=instrumento musical
BALANÇA=instrumento de medida
BALÃO=relativo a voo
BALAÚSTRE=feita com madeira
BALCONISTA=uma profissão
BALEIA=animal marinho|um peixe
BALNEÁRIO=local de banhos
BAMBU=uma planta
BANANA=uma fruta|fruta tropical